UUUUUUUUUUU
U---W-W---U
UTW-W-W-WTU
UTT-W-W-TTU
U-W-WTW-W-U
USSWTTTWSSU
U-WTTTTTW-U
U-W-WTW-W-U
U-W-WWW-W-U
U-P-WBW---U
UUUUUUUUUUU

b,b,b,b,b,b,b,b,b,a,a,a,b,b,b,f,f,f,f,a