UUUUUUUUUUU
U--WWWWW--U
U-W-W-W-W-U
U-W-W-W-W-U
U-W-W-W-W-U
USW-S-S-WSU
U-W-W-W-W-U
U-W-W-W-W-U
U-W-WWW-W-U
U-P-W-W---U
UUUUUUUUUUU

bbbbbbb