UUUUUUUUUUU
U-T-WTW-T-U
U-W-TWT-W-U
U-T-WTW-T-U
U-W-TWT-W-U
UWSSTTTSSWU
U-T-WTW-T-U
U-W-TWT-W-U
U-T-WWW-T-U
U-WPWBW---U
UUUUUUUUUUU

b,b,f,f,a,a,p,p,b,b,f,f,a,a,p,p,b,b,f,f