UUUUUUUUUUU
U--WWWWW--U
U---WWW---U
U-WSWWWSW-U
U-W-W-W-W-U
UwWTSSSTWwU
US--WWW--SU
UWW-----WWU
US--WWW--SU
U-P-WBW---U
UUUUUUUUUUU

f,f,b,a,p,f,f,b,a,p,f,f,b,a,p,f,f,b,a,p