UUUUUUUUUUUUUUU
U-----W-W-----U
U-W-WWW-WWW-W-U
U-WTW-W-W-WTW-U
U-TTT-W-W-TTT-U
U-W-W-WTW-W-W-U
USS--WTTTW--SSU
USS--WTTTW--SSU
U-W-WTWTWTW-W-U
U-W-WTTTTTW-W-U
U-W-W-WTW-W-W-U
U-W-WSWWWSW-W-U
U-W-W-WWW-W-W-U
U---P-WBW-----U
UUUUUUUUUUUUUUU