UUUUUUUUUUU
UW--W--W--U
U-W--W--W-U
U--W--W--WU
UW--W--W--U
U--S--S--SU
UW--W--W--U
U-W--W--W-U
U--WWWW--WU
UWP-WBWW--U
UUUUUUUUUUU

ffbbbpfaaabpbaffapaf