UUUUUUUUUUU
U--WSSSW--U
UWWTTTTTWWU
UWW-www-WWU
UTTW---WTTU
U-WWwwwWW-U
UT--TTT--TU
UTW--T--WTU
U---WWW---U
U-P-WBW---U
UUUUUUUUUUU

f,f,b,a,p,f,f,b,a,p,f,f,b,a,p,f,f,b,a,p