UUUUUUUUUUU
U---------U
U---------U
U-WSWWWSW-U
U-WWWWWWW-U
U-SWWWWWS-U
U-WSSSSSW-U
U---------U
U---WWW---U
U-P-WBW---U
UUUUUUUUUUU

faaffaappaaffaafppbb