UUUUUUUUUUUUUUU
U-W---------W-U
U-WWW-----WWW-U
U-WTW-----WTW-U
U-WWW-----WWW-U
U-SSS-----SSS-U
UWWWWWS-SWWWWWU
UWWWWWS-SWWWWWU
UWWW-------WWWU
U-W-WTTTTTW-W-U
U-W-WTTTTTW-W-U
U-W-WTTTTTW-W-U
U-SSSTWWWTSSS-U
U---PTWBWT----U
UUUUUUUUUUUUUUU