UUUUUUUUUUU
USS-----SSU
U-WWW-WWW-U
U-WWTTTWW-U
UWWWTTTWWWU
UTTTwwwTTTU
UWWTTTTTWWU
UWW-----WWU
UW--WWW--WU
U-P-WBW---U
UUUUUUUUUUU

fbpbaaapffbbfapbbfaf