UUUUUUUUUUUUUUU
U-TWT-WTW-TWT-U
U-WTW-TWT-WTW-U
U-TWT-WTW-TWT-U
U-WTW-TWT-WTW-U
U-TWT-WTW-TWT-U
U-WTW-TWT-WTW-U
UWSSSSTTTSSSSWU
U-TWT-WTW-TWT-U
U-WTW-TWT-WTW-U
U-TWT-WTW-TWT-U
U-WTW-TWT-WTW-U
U-TWT-WWW-TWT-U
U---P-WBW-----U
UUUUUUUUUUUUUUU