UUUUUUUUUUU
USS-----SSU
U--TTTTT--U
USSS---SSSU
Uww--S--wwU
UTWWTTTWWTU
UTww---wwTU
US--SSS--SU
U---WWW---U
U-P-WBW---U
UUUUUUUUUUU

a,a,p,p,b,b,f,f,f,a,a,a,b,b,b,p,p,b,b,a