UUUUUUUUUUU
U------WWWU
U-----WWW-U
UTTTTWWW--U
UwwwWWW---U
UWWWWW--SSU
UwwT----SSU
UTTT----SSU
U---WWW---U
U-P-WBW---U
UUUUUUUUUUU

a,a,b,a,a,p,b,b,b,f,f,a,a,a,a,a,p,b,f,f