UUUUUUUUUUU
U---------U
U--S---S--U
U-SS---SS-U
USSTTTTTSSU
USwW-W-WwSU
USSTTTTTSSU
US-------SU
U---WWW---U
U-P-WBW---U
UUUUUUUUUUU

f,b,f,a,f,a,b,a,b,p,b,p,f,p,f,a,f,a,b,b