UUUUUUUUUUUUUUU
U-------------U
U----S---S----U
U---SS---SS---U
U--SSTTTTTSS--U
U-SSSTTTTTSSS-U
USwwW-W-W-WwwSU
USww-W-W-W-wwSU
USwwW-W-W-WwwSU
U-SSSTTTTTSSS-U
U--SSTTTTTSS--U
U--S-------S--U
U-----WWW-----U
U---P-WBW-----U
UUUUUUUUUUUUUUU