UUUUUUUUUUU
USSSSSSSSSU
USSSSSSSSSU
U---------U
U---------U
UWWWWWWWWWU
UWW-----WWU
UWW-----WWU
UWW-WWWWWWU
USSPWBWSSSU
UUUUUUUUUUU

pppppfffffaaaaabbpff