UUUUUUUUUUU
UWWW---WWWU
U---------U
UTT-----TTU
Uw-SSSSS-wU
Uw-SSSSS-wU
Uw-SSSSS-wU
UTT-----TTU
U---WWW---U
U-P-WBW---U
UUUUUUUUUUU

b,f,f,f,p,b,b,b,a,p,f,f,a,a,b,b,b,a,a,a