UUUUUUUUUUU
U---WWW---U
U-WWWWWWW-U
U--WWWWW--U
U---SSS---U
U---------U
U-WWW-WWW-U
U--TTWTT--U
U---WWW---U
U--PWBW---U
UUUUUUUUUUU

bafbbappbfbfabaaapff