UUUUUUUUUUU
U-W-----W-U
U-WW---WW-U
UWW-----WWU
USSS---SSSU
UWWWS-SWWWU
UWWW---WWWU
U-WTTTTTW-U
USSTWWWTSSU
U-PTWBWT--U
UUUUUUUUUUU

bbbbppabbffabbpfffaa