UUUUUUUUUUU
U---------U
U---------U
U---------U
US-------SU
U---------U
US-------SU
U----P----U
U---WWW---U
U---WBW---U
UUUUUUUUUUU

bbbpbbbpbbbpbbbpbbba