UUUUUUUUUUU
U--WWWWW--U
U-W-W-W-W-U
U-W-W-W-W-U
U-W-W-W-W-U
USW-S-S-WSU
U-W-W-W-W-U
U-W-W-W-W-U
U-W-WWW-W-U
U-P-WBW---U
UUUUUUUUUUU

b,b,b,b,b,b,b,b,b,b,b,b,f,f,f,b,b,f,b,a