UUUUUUUUUUUUUUU
U----WWWWW----U
U---WWWWWWW---U
U--WWSWWWSWW--U
U--WWWWWWWWW--U
U---W-W-W-W---U
U-------------U
UwWTTTSSSTTTWwU
US----WWW----SU
U--WW-----WW--U
U--WW-----WW--U
U---W-----W---U
US--W-WWW-W--SU
USS-P-WBW---SSU
UUUUUUUUUUUUUUU