UUUUUUUUUUUUUUU
U----WSSSW----U
U--WWTTTTTWW--U
U-WWWTTTTTWWW-U
U--WW-www-WW--U
U--TTW---WTT--U
U-------------U
USS-WWwwwWW-SSU
USS-WWwwwWW-SSU
UTT---TTT---TTU
UTWW--TTT--WWTU
U---WW---WW---U
U-----WWW-----U
U---P-WBW-----U
UUUUUUUUUUUUUUU

f,f,b,a,p,f,f,b,a,p,f,f,b,a,p,f,f,b,a,p