UUUUUUUUUUUUUUU
USS---------SSU
US---S---S---SU
U-WWW-----WWW-U
U-WTW-----WTW-U
U-TWWWTTTWWWT-U
UWWWTTTTTTTWWWU
UTTTTwwwwwTTTTU
UWWWTTTTTTTWWWU
US-----------SU
U--WWWWWWWWW--U
UWW---------WWU
U-WW--WWW-WW--U
U---P-WBW-----U
UUUUUUUUUUUUUUU