UUUUUUUUUUU
USS-----SSU
U--TTTTT--U
USSS---SSSU
Uww--S--wwU
UTWWTTTWWTU
UwwT---TwwU
US--SSS--SU
U---WWW---U
U-P-WBW---U
UUUUUUUUUUU

aappbbfffaaabbbppbba