UUUUUUUUUUUUUUU
USS---------SSU
USSWW-----WWSSU
U-WWW-----WWW-U
U----TTTTT----U
U-SSS-----SSS-U
Uww---SSS---wwU
UwwT--SSS--TwwU
UTTTWWTTTWWTTTU
USWTww---wwTWSU
USW---WWW---WSU
USW---SSS---WSU
U-----WWW-----U
U---P-WBW-----U
UUUUUUUUUUUUUUU

a,a,p,p,b,b,f,f,f,a,a,a,b,b,b,p,p,b,b,a